0 3 3 3 3 3 3 3 0 
2 0 3 3 3 3 3 0 2 
2 2 0 3 3 3 0 2 2 
2 2 2 0 3 0 2 2 2 
2 2 2 2 0 2 2 2 2 
2 2 2 0 4 0 2 2 2 
